1111111111111111
1C00001C10010C11
1000001010000001
1110111000010001
1000000100000001
1EP000111000X011
1000000100000001
1110110000000001
1000010000000001
1000000100101001
1C000000000000C1
1111111111111111
