1111111111111111
1P00001E10010011
1000001010000001
111C000000010001
1000000100000001
110C00111000X011
1000000100000001
111C000100000001
1000000000000001
1111000100101001
1000000000000001
1111111111111111
